###############
#             #
#   ████  ████#
#   ████  ████#
#             #
#             #
#             #
#             #
#     ▔▔▔     #
