####################
#                  #
#                  #
#                  #
#                  #
#        ████      #
#                  #
#                  #
#                  #
#       ▔         #
