####################
#                  #
#                  #
#     █████        #
#     █████        #
#     █████        #
#                  #
#                  #
#                  #
#                  #
#                  #
#       ▔▔▔▔▔      #
