##############
#            #
#            #
#    ███     #
#    ███     #
#            #
#            #
#            #
#            #
#     ▔▔▔▔   #
