############
#          #
#  ███     #
#  ███     #
#          #
#          #
#          #
#     ▔▔   #
